Stage 1
######
#  P #
#o####
#O#
# #
###
=====
Stage 2
  #######
###  O  ###
#    o    #
# Oo P oO #
###  o  ###
 #   O  #
 ########