Stage 1
######
#  P #
#o####
#O#
# #
###
=====
Stage 2
  ###
  #O#
  # ####
###o oO#
#O oP###
####o#
   #O#
   ###
=====
Stage 3
######
#P   #
#  oO#
# Oo #
######
=====
Stage 4
#####
#P  ##
#Oo0 #
#  # #
#    #
######
=====
Stage 5
######
#P   ##
# oo  #
# #O O#
#     #
#######